###########
#....#...M#
#.##.#.##.#
#.#.....#.#
#.#.###.#.#
#....@....#
#.#.###.#.#
#.#.....#.#
#.##.#.##.#
#M...#....#
###########